Parameter name: pre_train_model.embeddings.word_embeddings.weight 	Shape: torch.Size([30522, 768])
Parameter name: pre_train_model.embeddings.position_embeddings.weight 	Shape: torch.Size([512, 768])
Parameter name: pre_train_model.embeddings.token_type_embeddings.weight 	Shape: torch.Size([2, 768])
Parameter name: pre_train_model.embeddings.LayerNorm.weight 	Shape: torch.Size([768])
Parameter name: pre_train_model.embeddings.LayerNorm.bias 	Shape: torch.Size([768])
Parameter name: pre_train_model.encoder.layer.0.attention.self.query.weight 	Shape: torch.Size([768, 768])
Parameter name: pre_train_model.encoder.layer.0.attention.self.query.bias 	Shape: torch.Size([768])
Parameter name: pre_train_model.encoder.layer.0.attention.self.key.weight 	Shape: torch.Size([768, 768])
Parameter name: pre_train_model.encoder.layer.0.attention.self.key.bias 	Shape: torch.Size([768])
Parameter name: pre_train_model.encoder.layer.0.attention.self.value.weight 	Shape: torch.Size([768, 768])
Parameter name: pre_train_model.encoder.layer.0.attention.self.value.bias 	Shape: torch.Size([768])
Parameter name: pre_train_model.encoder.layer.0.attention.output.dense.weight 	Shape: torch.Size([768, 768])
Parameter name: pre_train_model.encoder.layer.0.attention.output.dense.bias 	Shape: torch.Size([768])
Parameter name: pre_train_model.encoder.layer.0.attention.output.LayerNorm.weight 	Shape: torch.Size([768])
Parameter name: pre_train_model.encoder.layer.0.attention.output.LayerNorm.bias 	Shape: torch.Size([768])
Parameter name: pre_train_model.encoder.layer.0.intermediate.dense.weight 	Shape: torch.Size([3072, 768])
Parameter name: pre_train_model.encoder.layer.0.intermediate.dense.bias 	Shape: torch.Size([3072])
Parameter name: pre_train_model.encoder.layer.0.output.dense.weight 	Shape: torch.Size([768, 3072])
Parameter name: pre_train_model.encoder.layer.0.output.dense.bias 	Shape: torch.Size([768])
Parameter name: pre_train_model.encoder.layer.0.output.LayerNorm.weight 	Shape: torch.Size([768])
Parameter name: pre_train_model.encoder.layer.0.output.LayerNorm.bias 	Shape: torch.Size([768])
Parameter name: pre_train_model.encoder.layer.1.attention.self.query.weight 	Shape: torch.Size([768, 768])
Parameter name: pre_train_model.encoder.layer.1.attention.self.query.bias 	Shape: torch.Size([768])
Parameter name: pre_train_model.encoder.layer.1.attention.self.key.weight 	Shape: torch.Size([768, 768])
Parameter name: pre_train_model.encoder.layer.1.attention.self.key.bias 	Shape: torch.Size([768])
Parameter name: pre_train_model.encoder.layer.1.attention.self.value.weight 	Shape: torch.Size([768, 768])
Parameter name: pre_train_model.encoder.layer.1.attention.self.value.bias 	Shape: torch.Size([768])
Parameter name: pre_train_model.encoder.layer.1.attention.output.dense.weight 	Shape: torch.Size([768, 768])
Parameter name: pre_train_model.encoder.layer.1.attention.output.dense.bias 	Shape: torch.Size([768])
Parameter name: pre_train_model.encoder.layer.1.attention.output.LayerNorm.weight 	Shape: torch.Size([768])
Parameter name: pre_train_model.encoder.layer.1.attention.output.LayerNorm.bias 	Shape: torch.Size([768])
Parameter name: pre_train_model.encoder.layer.1.intermediate.dense.weight 	Shape: torch.Size([3072, 768])
Parameter name: pre_train_model.encoder.layer.1.intermediate.dense.bias 	Shape: torch.Size([3072])
Parameter name: pre_train_model.encoder.layer.1.output.dense.weight 	Shape: torch.Size([768, 3072])
Parameter name: pre_train_model.encoder.layer.1.output.dense.bias 	Shape: torch.Size([768])
Parameter name: pre_train_model.encoder.layer.1.output.LayerNorm.weight 	Shape: torch.Size([768])
Parameter name: pre_train_model.encoder.layer.1.output.LayerNorm.bias 	Shape: torch.Size([768])
Parameter name: pre_train_model.encoder.layer.2.attention.self.query.weight 	Shape: torch.Size([768, 768])
Parameter name: pre_train_model.encoder.layer.2.attention.self.query.bias 	Shape: torch.Size([768])
Parameter name: pre_train_model.encoder.layer.2.attention.self.key.weight 	Shape: torch.Size([768, 768])
Parameter name: pre_train_model.encoder.layer.2.attention.self.key.bias 	Shape: torch.Size([768])
Parameter name: pre_train_model.encoder.layer.2.attention.self.value.weight 	Shape: torch.Size([768, 768])
Parameter name: pre_train_model.encoder.layer.2.attention.self.value.bias 	Shape: torch.Size([768])
Parameter name: pre_train_model.encoder.layer.2.attention.output.dense.weight 	Shape: torch.Size([768, 768])
Parameter name: pre_train_model.encoder.layer.2.attention.output.dense.bias 	Shape: torch.Size([768])
Parameter name: pre_train_model.encoder.layer.2.attention.output.LayerNorm.weight 	Shape: torch.Size([768])
Parameter name: pre_train_model.encoder.layer.2.attention.output.LayerNorm.bias 	Shape: torch.Size([768])
Parameter name: pre_train_model.encoder.layer.2.intermediate.dense.weight 	Shape: torch.Size([3072, 768])
Parameter name: pre_train_model.encoder.layer.2.intermediate.dense.bias 	Shape: torch.Size([3072])
Parameter name: pre_train_model.encoder.layer.2.output.dense.weight 	Shape: torch.Size([768, 3072])
Parameter name: pre_train_model.encoder.layer.2.output.dense.bias 	Shape: torch.Size([768])
Parameter name: pre_train_model.encoder.layer.2.output.LayerNorm.weight 	Shape: torch.Size([768])
Parameter name: pre_train_model.encoder.layer.2.output.LayerNorm.bias 	Shape: torch.Size([768])
Parameter name: pre_train_model.encoder.layer.3.attention.self.query.weight 	Shape: torch.Size([768, 768])
Parameter name: pre_train_model.encoder.layer.3.attention.self.query.bias 	Shape: torch.Size([768])
Parameter name: pre_train_model.encoder.layer.3.attention.self.key.weight 	Shape: torch.Size([768, 768])
Parameter name: pre_train_model.encoder.layer.3.attention.self.key.bias 	Shape: torch.Size([768])
Parameter name: pre_train_model.encoder.layer.3.attention.self.value.weight 	Shape: torch.Size([768, 768])
Parameter name: pre_train_model.encoder.layer.3.attention.self.value.bias 	Shape: torch.Size([768])
Parameter name: pre_train_model.encoder.layer.3.attention.output.dense.weight 	Shape: torch.Size([768, 768])
Parameter name: pre_train_model.encoder.layer.3.attention.output.dense.bias 	Shape: torch.Size([768])
Parameter name: pre_train_model.encoder.layer.3.attention.output.LayerNorm.weight 	Shape: torch.Size([768])
Parameter name: pre_train_model.encoder.layer.3.attention.output.LayerNorm.bias 	Shape: torch.Size([768])
Parameter name: pre_train_model.encoder.layer.3.intermediate.dense.weight 	Shape: torch.Size([3072, 768])
Parameter name: pre_train_model.encoder.layer.3.intermediate.dense.bias 	Shape: torch.Size([3072])
Parameter name: pre_train_model.encoder.layer.3.output.dense.weight 	Shape: torch.Size([768, 3072])
Parameter name: pre_train_model.encoder.layer.3.output.dense.bias 	Shape: torch.Size([768])
Parameter name: pre_train_model.encoder.layer.3.output.LayerNorm.weight 	Shape: torch.Size([768])
Parameter name: pre_train_model.encoder.layer.3.output.LayerNorm.bias 	Shape: torch.Size([768])
Parameter name: pre_train_model.encoder.layer.4.attention.self.query.weight 	Shape: torch.Size([768, 768])
Parameter name: pre_train_model.encoder.layer.4.attention.self.query.bias 	Shape: torch.Size([768])
Parameter name: pre_train_model.encoder.layer.4.attention.self.key.weight 	Shape: torch.Size([768, 768])
Parameter name: pre_train_model.encoder.layer.4.attention.self.key.bias 	Shape: torch.Size([768])
Parameter name: pre_train_model.encoder.layer.4.attention.self.value.weight 	Shape: torch.Size([768, 768])
Parameter name: pre_train_model.encoder.layer.4.attention.self.value.bias 	Shape: torch.Size([768])
Parameter name: pre_train_model.encoder.layer.4.attention.output.dense.weight 	Shape: torch.Size([768, 768])
Parameter name: pre_train_model.encoder.layer.4.attention.output.dense.bias 	Shape: torch.Size([768])
Parameter name: pre_train_model.encoder.layer.4.attention.output.LayerNorm.weight 	Shape: torch.Size([768])
Parameter name: pre_train_model.encoder.layer.4.attention.output.LayerNorm.bias 	Shape: torch.Size([768])
Parameter name: pre_train_model.encoder.layer.4.intermediate.dense.weight 	Shape: torch.Size([3072, 768])
Parameter name: pre_train_model.encoder.layer.4.intermediate.dense.bias 	Shape: torch.Size([3072])
Parameter name: pre_train_model.encoder.layer.4.output.dense.weight 	Shape: torch.Size([768, 3072])
Parameter name: pre_train_model.encoder.layer.4.output.dense.bias 	Shape: torch.Size([768])
Parameter name: pre_train_model.encoder.layer.4.output.LayerNorm.weight 	Shape: torch.Size([768])
Parameter name: pre_train_model.encoder.layer.4.output.LayerNorm.bias 	Shape: torch.Size([768])
Parameter name: pre_train_model.encoder.layer.5.attention.self.query.weight 	Shape: torch.Size([768, 768])
Parameter name: pre_train_model.encoder.layer.5.attention.self.query.bias 	Shape: torch.Size([768])
Parameter name: pre_train_model.encoder.layer.5.attention.self.key.weight 	Shape: torch.Size([768, 768])
Parameter name: pre_train_model.encoder.layer.5.attention.self.key.bias 	Shape: torch.Size([768])
Parameter name: pre_train_model.encoder.layer.5.attention.self.value.weight 	Shape: torch.Size([768, 768])
Parameter name: pre_train_model.encoder.layer.5.attention.self.value.bias 	Shape: torch.Size([768])
Parameter name: pre_train_model.encoder.layer.5.attention.output.dense.weight 	Shape: torch.Size([768, 768])
Parameter name: pre_train_model.encoder.layer.5.attention.output.dense.bias 	Shape: torch.Size([768])
Parameter name: pre_train_model.encoder.layer.5.attention.output.LayerNorm.weight 	Shape: torch.Size([768])
Parameter name: pre_train_model.encoder.layer.5.attention.output.LayerNorm.bias 	Shape: torch.Size([768])
Parameter name: pre_train_model.encoder.layer.5.intermediate.dense.weight 	Shape: torch.Size([3072, 768])
Parameter name: pre_train_model.encoder.layer.5.intermediate.dense.bias 	Shape: torch.Size([3072])
Parameter name: pre_train_model.encoder.layer.5.output.dense.weight 	Shape: torch.Size([768, 3072])
Parameter name: pre_train_model.encoder.layer.5.output.dense.bias 	Shape: torch.Size([768])
Parameter name: pre_train_model.encoder.layer.5.output.LayerNorm.weight 	Shape: torch.Size([768])
Parameter name: pre_train_model.encoder.layer.5.output.LayerNorm.bias 	Shape: torch.Size([768])
Parameter name: pre_train_model.encoder.layer.6.attention.self.query.weight 	Shape: torch.Size([768, 768])
Parameter name: pre_train_model.encoder.layer.6.attention.self.query.bias 	Shape: torch.Size([768])
Parameter name: pre_train_model.encoder.layer.6.attention.self.key.weight 	Shape: torch.Size([768, 768])
Parameter name: pre_train_model.encoder.layer.6.attention.self.key.bias 	Shape: torch.Size([768])
Parameter name: pre_train_model.encoder.layer.6.attention.self.value.weight 	Shape: torch.Size([768, 768])
Parameter name: pre_train_model.encoder.layer.6.attention.self.value.bias 	Shape: torch.Size([768])
Parameter name: pre_train_model.encoder.layer.6.attention.output.dense.weight 	Shape: torch.Size([768, 768])
Parameter name: pre_train_model.encoder.layer.6.attention.output.dense.bias 	Shape: torch.Size([768])
Parameter name: pre_train_model.encoder.layer.6.attention.output.LayerNorm.weight 	Shape: torch.Size([768])
Parameter name: pre_train_model.encoder.layer.6.attention.output.LayerNorm.bias 	Shape: torch.Size([768])
Parameter name: pre_train_model.encoder.layer.6.intermediate.dense.weight 	Shape: torch.Size([3072, 768])
Parameter name: pre_train_model.encoder.layer.6.intermediate.dense.bias 	Shape: torch.Size([3072])
Parameter name: pre_train_model.encoder.layer.6.output.dense.weight 	Shape: torch.Size([768, 3072])
Parameter name: pre_train_model.encoder.layer.6.output.dense.bias 	Shape: torch.Size([768])
Parameter name: pre_train_model.encoder.layer.6.output.LayerNorm.weight 	Shape: torch.Size([768])
Parameter name: pre_train_model.encoder.layer.6.output.LayerNorm.bias 	Shape: torch.Size([768])
Parameter name: pre_train_model.encoder.layer.7.attention.self.query.weight 	Shape: torch.Size([768, 768])
Parameter name: pre_train_model.encoder.layer.7.attention.self.query.bias 	Shape: torch.Size([768])
Parameter name: pre_train_model.encoder.layer.7.attention.self.key.weight 	Shape: torch.Size([768, 768])
Parameter name: pre_train_model.encoder.layer.7.attention.self.key.bias 	Shape: torch.Size([768])
Parameter name: pre_train_model.encoder.layer.7.attention.self.value.weight 	Shape: torch.Size([768, 768])
Parameter name: pre_train_model.encoder.layer.7.attention.self.value.bias 	Shape: torch.Size([768])
Parameter name: pre_train_model.encoder.layer.7.attention.output.dense.weight 	Shape: torch.Size([768, 768])
Parameter name: pre_train_model.encoder.layer.7.attention.output.dense.bias 	Shape: torch.Size([768])
Parameter name: pre_train_model.encoder.layer.7.attention.output.LayerNorm.weight 	Shape: torch.Size([768])
Parameter name: pre_train_model.encoder.layer.7.attention.output.LayerNorm.bias 	Shape: torch.Size([768])
Parameter name: pre_train_model.encoder.layer.7.intermediate.dense.weight 	Shape: torch.Size([3072, 768])
Parameter name: pre_train_model.encoder.layer.7.intermediate.dense.bias 	Shape: torch.Size([3072])
Parameter name: pre_train_model.encoder.layer.7.output.dense.weight 	Shape: torch.Size([768, 3072])
Parameter name: pre_train_model.encoder.layer.7.output.dense.bias 	Shape: torch.Size([768])
Parameter name: pre_train_model.encoder.layer.7.output.LayerNorm.weight 	Shape: torch.Size([768])
Parameter name: pre_train_model.encoder.layer.7.output.LayerNorm.bias 	Shape: torch.Size([768])
Parameter name: pre_train_model.encoder.layer.8.attention.self.query.weight 	Shape: torch.Size([768, 768])
Parameter name: pre_train_model.encoder.layer.8.attention.self.query.bias 	Shape: torch.Size([768])
Parameter name: pre_train_model.encoder.layer.8.attention.self.key.weight 	Shape: torch.Size([768, 768])
Parameter name: pre_train_model.encoder.layer.8.attention.self.key.bias 	Shape: torch.Size([768])
Parameter name: pre_train_model.encoder.layer.8.attention.self.value.weight 	Shape: torch.Size([768, 768])
Parameter name: pre_train_model.encoder.layer.8.attention.self.value.bias 	Shape: torch.Size([768])
Parameter name: pre_train_model.encoder.layer.8.attention.output.dense.weight 	Shape: torch.Size([768, 768])
Parameter name: pre_train_model.encoder.layer.8.attention.output.dense.bias 	Shape: torch.Size([768])
Parameter name: pre_train_model.encoder.layer.8.attention.output.LayerNorm.weight 	Shape: torch.Size([768])
Parameter name: pre_train_model.encoder.layer.8.attention.output.LayerNorm.bias 	Shape: torch.Size([768])
Parameter name: pre_train_model.encoder.layer.8.intermediate.dense.weight 	Shape: torch.Size([3072, 768])
Parameter name: pre_train_model.encoder.layer.8.intermediate.dense.bias 	Shape: torch.Size([3072])
Parameter name: pre_train_model.encoder.layer.8.output.dense.weight 	Shape: torch.Size([768, 3072])
Parameter name: pre_train_model.encoder.layer.8.output.dense.bias 	Shape: torch.Size([768])
Parameter name: pre_train_model.encoder.layer.8.output.LayerNorm.weight 	Shape: torch.Size([768])
Parameter name: pre_train_model.encoder.layer.8.output.LayerNorm.bias 	Shape: torch.Size([768])
Parameter name: pre_train_model.encoder.layer.9.attention.self.query.weight 	Shape: torch.Size([768, 768])
Parameter name: pre_train_model.encoder.layer.9.attention.self.query.bias 	Shape: torch.Size([768])
Parameter name: pre_train_model.encoder.layer.9.attention.self.key.weight 	Shape: torch.Size([768, 768])
Parameter name: pre_train_model.encoder.layer.9.attention.self.key.bias 	Shape: torch.Size([768])
Parameter name: pre_train_model.encoder.layer.9.attention.self.value.weight 	Shape: torch.Size([768, 768])
Parameter name: pre_train_model.encoder.layer.9.attention.self.value.bias 	Shape: torch.Size([768])
Parameter name: pre_train_model.encoder.layer.9.attention.output.dense.weight 	Shape: torch.Size([768, 768])
Parameter name: pre_train_model.encoder.layer.9.attention.output.dense.bias 	Shape: torch.Size([768])
Parameter name: pre_train_model.encoder.layer.9.attention.output.LayerNorm.weight 	Shape: torch.Size([768])
Parameter name: pre_train_model.encoder.layer.9.attention.output.LayerNorm.bias 	Shape: torch.Size([768])
Parameter name: pre_train_model.encoder.layer.9.intermediate.dense.weight 	Shape: torch.Size([3072, 768])
Parameter name: pre_train_model.encoder.layer.9.intermediate.dense.bias 	Shape: torch.Size([3072])
Parameter name: pre_train_model.encoder.layer.9.output.dense.weight 	Shape: torch.Size([768, 3072])
Parameter name: pre_train_model.encoder.layer.9.output.dense.bias 	Shape: torch.Size([768])
Parameter name: pre_train_model.encoder.layer.9.output.LayerNorm.weight 	Shape: torch.Size([768])
Parameter name: pre_train_model.encoder.layer.9.output.LayerNorm.bias 	Shape: torch.Size([768])
Parameter name: pre_train_model.encoder.layer.10.attention.self.query.weight 	Shape: torch.Size([768, 768])
Parameter name: pre_train_model.encoder.layer.10.attention.self.query.bias 	Shape: torch.Size([768])
Parameter name: pre_train_model.encoder.layer.10.attention.self.key.weight 	Shape: torch.Size([768, 768])
Parameter name: pre_train_model.encoder.layer.10.attention.self.key.bias 	Shape: torch.Size([768])
Parameter name: pre_train_model.encoder.layer.10.attention.self.value.weight 	Shape: torch.Size([768, 768])
Parameter name: pre_train_model.encoder.layer.10.attention.self.value.bias 	Shape: torch.Size([768])
Parameter name: pre_train_model.encoder.layer.10.attention.output.dense.weight 	Shape: torch.Size([768, 768])
Parameter name: pre_train_model.encoder.layer.10.attention.output.dense.bias 	Shape: torch.Size([768])
Parameter name: pre_train_model.encoder.layer.10.attention.output.LayerNorm.weight 	Shape: torch.Size([768])
Parameter name: pre_train_model.encoder.layer.10.attention.output.LayerNorm.bias 	Shape: torch.Size([768])
Parameter name: pre_train_model.encoder.layer.10.intermediate.dense.weight 	Shape: torch.Size([3072, 768])
Parameter name: pre_train_model.encoder.layer.10.intermediate.dense.bias 	Shape: torch.Size([3072])
Parameter name: pre_train_model.encoder.layer.10.output.dense.weight 	Shape: torch.Size([768, 3072])
Parameter name: pre_train_model.encoder.layer.10.output.dense.bias 	Shape: torch.Size([768])
Parameter name: pre_train_model.encoder.layer.10.output.LayerNorm.weight 	Shape: torch.Size([768])
Parameter name: pre_train_model.encoder.layer.10.output.LayerNorm.bias 	Shape: torch.Size([768])
Parameter name: pre_train_model.encoder.layer.11.attention.self.query.weight 	Shape: torch.Size([768, 768])
Parameter name: pre_train_model.encoder.layer.11.attention.self.query.bias 	Shape: torch.Size([768])
Parameter name: pre_train_model.encoder.layer.11.attention.self.key.weight 	Shape: torch.Size([768, 768])
Parameter name: pre_train_model.encoder.layer.11.attention.self.key.bias 	Shape: torch.Size([768])
Parameter name: pre_train_model.encoder.layer.11.attention.self.value.weight 	Shape: torch.Size([768, 768])
Parameter name: pre_train_model.encoder.layer.11.attention.self.value.bias 	Shape: torch.Size([768])
Parameter name: pre_train_model.encoder.layer.11.attention.output.dense.weight 	Shape: torch.Size([768, 768])
Parameter name: pre_train_model.encoder.layer.11.attention.output.dense.bias 	Shape: torch.Size([768])
Parameter name: pre_train_model.encoder.layer.11.attention.output.LayerNorm.weight 	Shape: torch.Size([768])
Parameter name: pre_train_model.encoder.layer.11.attention.output.LayerNorm.bias 	Shape: torch.Size([768])
Parameter name: pre_train_model.encoder.layer.11.intermediate.dense.weight 	Shape: torch.Size([3072, 768])
Parameter name: pre_train_model.encoder.layer.11.intermediate.dense.bias 	Shape: torch.Size([3072])
Parameter name: pre_train_model.encoder.layer.11.output.dense.weight 	Shape: torch.Size([768, 3072])
Parameter name: pre_train_model.encoder.layer.11.output.dense.bias 	Shape: torch.Size([768])
Parameter name: pre_train_model.encoder.layer.11.output.LayerNorm.weight 	Shape: torch.Size([768])
Parameter name: pre_train_model.encoder.layer.11.output.LayerNorm.bias 	Shape: torch.Size([768])
Parameter name: pre_train_model.pooler.dense.weight 	Shape: torch.Size([768, 768])
Parameter name: pre_train_model.pooler.dense.bias 	Shape: torch.Size([768])
Parameter name: mixwt.weights 	Shape: torch.Size([128])
Parameter name: logits.fc1.weight 	Shape: torch.Size([64, 769])
Parameter name: logits.fc1.bias 	Shape: torch.Size([64])
Parameter name: logits.fc3.weight 	Shape: torch.Size([1, 64])
Parameter name: logits.fc3.bias 	Shape: torch.Size([1])

Parameter name: pre_train_model.embeddings.word_embeddings.weight 	Shape: torch.Size([30522, 768])
Parameter name: pre_train_model.embeddings.position_embeddings.weight 	Shape: torch.Size([512, 768])
Parameter name: pre_train_model.embeddings.token_type_embeddings.weight 	Shape: torch.Size([2, 768])
Parameter name: pre_train_model.embeddings.LayerNorm.weight 	Shape: torch.Size([768])
Parameter name: pre_train_model.embeddings.LayerNorm.bias 	Shape: torch.Size([768])
Parameter name: pre_train_model.encoder.layer.0.attention.self.query.weight 	Shape: torch.Size([768, 768])
Parameter name: pre_train_model.encoder.layer.0.attention.self.query.bias 	Shape: torch.Size([768])
Parameter name: pre_train_model.encoder.layer.0.attention.self.key.weight 	Shape: torch.Size([768, 768])
Parameter name: pre_train_model.encoder.layer.0.attention.self.key.bias 	Shape: torch.Size([768])
Parameter name: pre_train_model.encoder.layer.0.attention.self.value.weight 	Shape: torch.Size([768, 768])
Parameter name: pre_train_model.encoder.layer.0.attention.self.value.bias 	Shape: torch.Size([768])
Parameter name: pre_train_model.encoder.layer.0.attention.output.dense.weight 	Shape: torch.Size([768, 768])
Parameter name: pre_train_model.encoder.layer.0.attention.output.dense.bias 	Shape: torch.Size([768])
Parameter name: pre_train_model.encoder.layer.0.attention.output.LayerNorm.weight 	Shape: torch.Size([768])
Parameter name: pre_train_model.encoder.layer.0.attention.output.LayerNorm.bias 	Shape: torch.Size([768])
Parameter name: pre_train_model.encoder.layer.0.intermediate.dense.weight 	Shape: torch.Size([3072, 768])
Parameter name: pre_train_model.encoder.layer.0.intermediate.dense.bias 	Shape: torch.Size([3072])
Parameter name: pre_train_model.encoder.layer.0.output.dense.weight 	Shape: torch.Size([768, 3072])
Parameter name: pre_train_model.encoder.layer.0.output.dense.bias 	Shape: torch.Size([768])
Parameter name: pre_train_model.encoder.layer.0.output.LayerNorm.weight 	Shape: torch.Size([768])
Parameter name: pre_train_model.encoder.layer.0.output.LayerNorm.bias 	Shape: torch.Size([768])
Parameter name: pre_train_model.encoder.layer.1.attention.self.query.weight 	Shape: torch.Size([768, 768])
Parameter name: pre_train_model.encoder.layer.1.attention.self.query.bias 	Shape: torch.Size([768])
Parameter name: pre_train_model.encoder.layer.1.attention.self.key.weight 	Shape: torch.Size([768, 768])
Parameter name: pre_train_model.encoder.layer.1.attention.self.key.bias 	Shape: torch.Size([768])
Parameter name: pre_train_model.encoder.layer.1.attention.self.value.weight 	Shape: torch.Size([768, 768])
Parameter name: pre_train_model.encoder.layer.1.attention.self.value.bias 	Shape: torch.Size([768])
Parameter name: pre_train_model.encoder.layer.1.attention.output.dense.weight 	Shape: torch.Size([768, 768])
Parameter name: pre_train_model.encoder.layer.1.attention.output.dense.bias 	Shape: torch.Size([768])
Parameter name: pre_train_model.encoder.layer.1.attention.output.LayerNorm.weight 	Shape: torch.Size([768])
Parameter name: pre_train_model.encoder.layer.1.attention.output.LayerNorm.bias 	Shape: torch.Size([768])
Parameter name: pre_train_model.encoder.layer.1.intermediate.dense.weight 	Shape: torch.Size([3072, 768])
Parameter name: pre_train_model.encoder.layer.1.intermediate.dense.bias 	Shape: torch.Size([3072])
Parameter name: pre_train_model.encoder.layer.1.output.dense.weight 	Shape: torch.Size([768, 3072])
Parameter name: pre_train_model.encoder.layer.1.output.dense.bias 	Shape: torch.Size([768])
Parameter name: pre_train_model.encoder.layer.1.output.LayerNorm.weight 	Shape: torch.Size([768])
Parameter name: pre_train_model.encoder.layer.1.output.LayerNorm.bias 	Shape: torch.Size([768])
Parameter name: pre_train_model.encoder.layer.2.attention.self.query.weight 	Shape: torch.Size([768, 768])
Parameter name: pre_train_model.encoder.layer.2.attention.self.query.bias 	Shape: torch.Size([768])
Parameter name: pre_train_model.encoder.layer.2.attention.self.key.weight 	Shape: torch.Size([768, 768])
Parameter name: pre_train_model.encoder.layer.2.attention.self.key.bias 	Shape: torch.Size([768])
Parameter name: pre_train_model.encoder.layer.2.attention.self.value.weight 	Shape: torch.Size([768, 768])
Parameter name: pre_train_model.encoder.layer.2.attention.self.value.bias 	Shape: torch.Size([768])
Parameter name: pre_train_model.encoder.layer.2.attention.output.dense.weight 	Shape: torch.Size([768, 768])
Parameter name: pre_train_model.encoder.layer.2.attention.output.dense.bias 	Shape: torch.Size([768])
Parameter name: pre_train_model.encoder.layer.2.attention.output.LayerNorm.weight 	Shape: torch.Size([768])
Parameter name: pre_train_model.encoder.layer.2.attention.output.LayerNorm.bias 	Shape: torch.Size([768])
Parameter name: pre_train_model.encoder.layer.2.intermediate.dense.weight 	Shape: torch.Size([3072, 768])
Parameter name: pre_train_model.encoder.layer.2.intermediate.dense.bias 	Shape: torch.Size([3072])
Parameter name: pre_train_model.encoder.layer.2.output.dense.weight 	Shape: torch.Size([768, 3072])
Parameter name: pre_train_model.encoder.layer.2.output.dense.bias 	Shape: torch.Size([768])
Parameter name: pre_train_model.encoder.layer.2.output.LayerNorm.weight 	Shape: torch.Size([768])
Parameter name: pre_train_model.encoder.layer.2.output.LayerNorm.bias 	Shape: torch.Size([768])
Parameter name: pre_train_model.encoder.layer.3.attention.self.query.weight 	Shape: torch.Size([768, 768])
Parameter name: pre_train_model.encoder.layer.3.attention.self.query.bias 	Shape: torch.Size([768])
Parameter name: pre_train_model.encoder.layer.3.attention.self.key.weight 	Shape: torch.Size([768, 768])
Parameter name: pre_train_model.encoder.layer.3.attention.self.key.bias 	Shape: torch.Size([768])
Parameter name: pre_train_model.encoder.layer.3.attention.self.value.weight 	Shape: torch.Size([768, 768])
Parameter name: pre_train_model.encoder.layer.3.attention.self.value.bias 	Shape: torch.Size([768])
Parameter name: pre_train_model.encoder.layer.3.attention.output.dense.weight 	Shape: torch.Size([768, 768])
Parameter name: pre_train_model.encoder.layer.3.attention.output.dense.bias 	Shape: torch.Size([768])
Parameter name: pre_train_model.encoder.layer.3.attention.output.LayerNorm.weight 	Shape: torch.Size([768])
Parameter name: pre_train_model.encoder.layer.3.attention.output.LayerNorm.bias 	Shape: torch.Size([768])
Parameter name: pre_train_model.encoder.layer.3.intermediate.dense.weight 	Shape: torch.Size([3072, 768])
Parameter name: pre_train_model.encoder.layer.3.intermediate.dense.bias 	Shape: torch.Size([3072])
Parameter name: pre_train_model.encoder.layer.3.output.dense.weight 	Shape: torch.Size([768, 3072])
Parameter name: pre_train_model.encoder.layer.3.output.dense.bias 	Shape: torch.Size([768])
Parameter name: pre_train_model.encoder.layer.3.output.LayerNorm.weight 	Shape: torch.Size([768])
Parameter name: pre_train_model.encoder.layer.3.output.LayerNorm.bias 	Shape: torch.Size([768])
Parameter name: pre_train_model.encoder.layer.4.attention.self.query.weight 	Shape: torch.Size([768, 768])
Parameter name: pre_train_model.encoder.layer.4.attention.self.query.bias 	Shape: torch.Size([768])
Parameter name: pre_train_model.encoder.layer.4.attention.self.key.weight 	Shape: torch.Size([768, 768])
Parameter name: pre_train_model.encoder.layer.4.attention.self.key.bias 	Shape: torch.Size([768])
Parameter name: pre_train_model.encoder.layer.4.attention.self.value.weight 	Shape: torch.Size([768, 768])
Parameter name: pre_train_model.encoder.layer.4.attention.self.value.bias 	Shape: torch.Size([768])
Parameter name: pre_train_model.encoder.layer.4.attention.output.dense.weight 	Shape: torch.Size([768, 768])
Parameter name: pre_train_model.encoder.layer.4.attention.output.dense.bias 	Shape: torch.Size([768])
Parameter name: pre_train_model.encoder.layer.4.attention.output.LayerNorm.weight 	Shape: torch.Size([768])
Parameter name: pre_train_model.encoder.layer.4.attention.output.LayerNorm.bias 	Shape: torch.Size([768])
Parameter name: pre_train_model.encoder.layer.4.intermediate.dense.weight 	Shape: torch.Size([3072, 768])
Parameter name: pre_train_model.encoder.layer.4.intermediate.dense.bias 	Shape: torch.Size([3072])
Parameter name: pre_train_model.encoder.layer.4.output.dense.weight 	Shape: torch.Size([768, 3072])
Parameter name: pre_train_model.encoder.layer.4.output.dense.bias 	Shape: torch.Size([768])
Parameter name: pre_train_model.encoder.layer.4.output.LayerNorm.weight 	Shape: torch.Size([768])
Parameter name: pre_train_model.encoder.layer.4.output.LayerNorm.bias 	Shape: torch.Size([768])
Parameter name: pre_train_model.encoder.layer.5.attention.self.query.weight 	Shape: torch.Size([768, 768])
Parameter name: pre_train_model.encoder.layer.5.attention.self.query.bias 	Shape: torch.Size([768])
Parameter name: pre_train_model.encoder.layer.5.attention.self.key.weight 	Shape: torch.Size([768, 768])
Parameter name: pre_train_model.encoder.layer.5.attention.self.key.bias 	Shape: torch.Size([768])
Parameter name: pre_train_model.encoder.layer.5.attention.self.value.weight 	Shape: torch.Size([768, 768])
Parameter name: pre_train_model.encoder.layer.5.attention.self.value.bias 	Shape: torch.Size([768])
Parameter name: pre_train_model.encoder.layer.5.attention.output.dense.weight 	Shape: torch.Size([768, 768])
Parameter name: pre_train_model.encoder.layer.5.attention.output.dense.bias 	Shape: torch.Size([768])
Parameter name: pre_train_model.encoder.layer.5.attention.output.LayerNorm.weight 	Shape: torch.Size([768])
Parameter name: pre_train_model.encoder.layer.5.attention.output.LayerNorm.bias 	Shape: torch.Size([768])
Parameter name: pre_train_model.encoder.layer.5.intermediate.dense.weight 	Shape: torch.Size([3072, 768])
Parameter name: pre_train_model.encoder.layer.5.intermediate.dense.bias 	Shape: torch.Size([3072])
Parameter name: pre_train_model.encoder.layer.5.output.dense.weight 	Shape: torch.Size([768, 3072])
Parameter name: pre_train_model.encoder.layer.5.output.dense.bias 	Shape: torch.Size([768])
Parameter name: pre_train_model.encoder.layer.5.output.LayerNorm.weight 	Shape: torch.Size([768])
Parameter name: pre_train_model.encoder.layer.5.output.LayerNorm.bias 	Shape: torch.Size([768])
Parameter name: pre_train_model.encoder.layer.6.attention.self.query.weight 	Shape: torch.Size([768, 768])
Parameter name: pre_train_model.encoder.layer.6.attention.self.query.bias 	Shape: torch.Size([768])
Parameter name: pre_train_model.encoder.layer.6.attention.self.key.weight 	Shape: torch.Size([768, 768])
Parameter name: pre_train_model.encoder.layer.6.attention.self.key.bias 	Shape: torch.Size([768])
Parameter name: pre_train_model.encoder.layer.6.attention.self.value.weight 	Shape: torch.Size([768, 768])
Parameter name: pre_train_model.encoder.layer.6.attention.self.value.bias 	Shape: torch.Size([768])
Parameter name: pre_train_model.encoder.layer.6.attention.output.dense.weight 	Shape: torch.Size([768, 768])
Parameter name: pre_train_model.encoder.layer.6.attention.output.dense.bias 	Shape: torch.Size([768])
Parameter name: pre_train_model.encoder.layer.6.attention.output.LayerNorm.weight 	Shape: torch.Size([768])
Parameter name: pre_train_model.encoder.layer.6.attention.output.LayerNorm.bias 	Shape: torch.Size([768])
Parameter name: pre_train_model.encoder.layer.6.intermediate.dense.weight 	Shape: torch.Size([3072, 768])
Parameter name: pre_train_model.encoder.layer.6.intermediate.dense.bias 	Shape: torch.Size([3072])
Parameter name: pre_train_model.encoder.layer.6.output.dense.weight 	Shape: torch.Size([768, 3072])
Parameter name: pre_train_model.encoder.layer.6.output.dense.bias 	Shape: torch.Size([768])
Parameter name: pre_train_model.encoder.layer.6.output.LayerNorm.weight 	Shape: torch.Size([768])
Parameter name: pre_train_model.encoder.layer.6.output.LayerNorm.bias 	Shape: torch.Size([768])
Parameter name: pre_train_model.encoder.layer.7.attention.self.query.weight 	Shape: torch.Size([768, 768])
Parameter name: pre_train_model.encoder.layer.7.attention.self.query.bias 	Shape: torch.Size([768])
Parameter name: pre_train_model.encoder.layer.7.attention.self.key.weight 	Shape: torch.Size([768, 768])
Parameter name: pre_train_model.encoder.layer.7.attention.self.key.bias 	Shape: torch.Size([768])
Parameter name: pre_train_model.encoder.layer.7.attention.self.value.weight 	Shape: torch.Size([768, 768])
Parameter name: pre_train_model.encoder.layer.7.attention.self.value.bias 	Shape: torch.Size([768])
Parameter name: pre_train_model.encoder.layer.7.attention.output.dense.weight 	Shape: torch.Size([768, 768])
Parameter name: pre_train_model.encoder.layer.7.attention.output.dense.bias 	Shape: torch.Size([768])
Parameter name: pre_train_model.encoder.layer.7.attention.output.LayerNorm.weight 	Shape: torch.Size([768])
Parameter name: pre_train_model.encoder.layer.7.attention.output.LayerNorm.bias 	Shape: torch.Size([768])
Parameter name: pre_train_model.encoder.layer.7.intermediate.dense.weight 	Shape: torch.Size([3072, 768])
Parameter name: pre_train_model.encoder.layer.7.intermediate.dense.bias 	Shape: torch.Size([3072])
Parameter name: pre_train_model.encoder.layer.7.output.dense.weight 	Shape: torch.Size([768, 3072])
Parameter name: pre_train_model.encoder.layer.7.output.dense.bias 	Shape: torch.Size([768])
Parameter name: pre_train_model.encoder.layer.7.output.LayerNorm.weight 	Shape: torch.Size([768])
Parameter name: pre_train_model.encoder.layer.7.output.LayerNorm.bias 	Shape: torch.Size([768])
Parameter name: pre_train_model.encoder.layer.8.attention.self.query.weight 	Shape: torch.Size([768, 768])
Parameter name: pre_train_model.encoder.layer.8.attention.self.query.bias 	Shape: torch.Size([768])
Parameter name: pre_train_model.encoder.layer.8.attention.self.key.weight 	Shape: torch.Size([768, 768])
Parameter name: pre_train_model.encoder.layer.8.attention.self.key.bias 	Shape: torch.Size([768])
Parameter name: pre_train_model.encoder.layer.8.attention.self.value.weight 	Shape: torch.Size([768, 768])
Parameter name: pre_train_model.encoder.layer.8.attention.self.value.bias 	Shape: torch.Size([768])
Parameter name: pre_train_model.encoder.layer.8.attention.output.dense.weight 	Shape: torch.Size([768, 768])
Parameter name: pre_train_model.encoder.layer.8.attention.output.dense.bias 	Shape: torch.Size([768])
Parameter name: pre_train_model.encoder.layer.8.attention.output.LayerNorm.weight 	Shape: torch.Size([768])
Parameter name: pre_train_model.encoder.layer.8.attention.output.LayerNorm.bias 	Shape: torch.Size([768])
Parameter name: pre_train_model.encoder.layer.8.intermediate.dense.weight 	Shape: torch.Size([3072, 768])
Parameter name: pre_train_model.encoder.layer.8.intermediate.dense.bias 	Shape: torch.Size([3072])
Parameter name: pre_train_model.encoder.layer.8.output.dense.weight 	Shape: torch.Size([768, 3072])
Parameter name: pre_train_model.encoder.layer.8.output.dense.bias 	Shape: torch.Size([768])
Parameter name: pre_train_model.encoder.layer.8.output.LayerNorm.weight 	Shape: torch.Size([768])
Parameter name: pre_train_model.encoder.layer.8.output.LayerNorm.bias 	Shape: torch.Size([768])
Parameter name: pre_train_model.encoder.layer.9.attention.self.query.weight 	Shape: torch.Size([768, 768])
Parameter name: pre_train_model.encoder.layer.9.attention.self.query.bias 	Shape: torch.Size([768])
Parameter name: pre_train_model.encoder.layer.9.attention.self.key.weight 	Shape: torch.Size([768, 768])
Parameter name: pre_train_model.encoder.layer.9.attention.self.key.bias 	Shape: torch.Size([768])
Parameter name: pre_train_model.encoder.layer.9.attention.self.value.weight 	Shape: torch.Size([768, 768])
Parameter name: pre_train_model.encoder.layer.9.attention.self.value.bias 	Shape: torch.Size([768])
Parameter name: pre_train_model.encoder.layer.9.attention.output.dense.weight 	Shape: torch.Size([768, 768])
Parameter name: pre_train_model.encoder.layer.9.attention.output.dense.bias 	Shape: torch.Size([768])
Parameter name: pre_train_model.encoder.layer.9.attention.output.LayerNorm.weight 	Shape: torch.Size([768])
Parameter name: pre_train_model.encoder.layer.9.attention.output.LayerNorm.bias 	Shape: torch.Size([768])
Parameter name: pre_train_model.encoder.layer.9.intermediate.dense.weight 	Shape: torch.Size([3072, 768])
Parameter name: pre_train_model.encoder.layer.9.intermediate.dense.bias 	Shape: torch.Size([3072])
Parameter name: pre_train_model.encoder.layer.9.output.dense.weight 	Shape: torch.Size([768, 3072])
Parameter name: pre_train_model.encoder.layer.9.output.dense.bias 	Shape: torch.Size([768])
Parameter name: pre_train_model.encoder.layer.9.output.LayerNorm.weight 	Shape: torch.Size([768])
Parameter name: pre_train_model.encoder.layer.9.output.LayerNorm.bias 	Shape: torch.Size([768])
Parameter name: pre_train_model.encoder.layer.10.attention.self.query.weight 	Shape: torch.Size([768, 768])
Parameter name: pre_train_model.encoder.layer.10.attention.self.query.bias 	Shape: torch.Size([768])
Parameter name: pre_train_model.encoder.layer.10.attention.self.key.weight 	Shape: torch.Size([768, 768])
Parameter name: pre_train_model.encoder.layer.10.attention.self.key.bias 	Shape: torch.Size([768])
Parameter name: pre_train_model.encoder.layer.10.attention.self.value.weight 	Shape: torch.Size([768, 768])
Parameter name: pre_train_model.encoder.layer.10.attention.self.value.bias 	Shape: torch.Size([768])
Parameter name: pre_train_model.encoder.layer.10.attention.output.dense.weight 	Shape: torch.Size([768, 768])
Parameter name: pre_train_model.encoder.layer.10.attention.output.dense.bias 	Shape: torch.Size([768])
Parameter name: pre_train_model.encoder.layer.10.attention.output.LayerNorm.weight 	Shape: torch.Size([768])
Parameter name: pre_train_model.encoder.layer.10.attention.output.LayerNorm.bias 	Shape: torch.Size([768])
Parameter name: pre_train_model.encoder.layer.10.intermediate.dense.weight 	Shape: torch.Size([3072, 768])
Parameter name: pre_train_model.encoder.layer.10.intermediate.dense.bias 	Shape: torch.Size([3072])
Parameter name: pre_train_model.encoder.layer.10.output.dense.weight 	Shape: torch.Size([768, 3072])
Parameter name: pre_train_model.encoder.layer.10.output.dense.bias 	Shape: torch.Size([768])
Parameter name: pre_train_model.encoder.layer.10.output.LayerNorm.weight 	Shape: torch.Size([768])
Parameter name: pre_train_model.encoder.layer.10.output.LayerNorm.bias 	Shape: torch.Size([768])
Parameter name: pre_train_model.encoder.layer.11.attention.self.query.weight 	Shape: torch.Size([768, 768])
Parameter name: pre_train_model.encoder.layer.11.attention.self.query.bias 	Shape: torch.Size([768])
Parameter name: pre_train_model.encoder.layer.11.attention.self.key.weight 	Shape: torch.Size([768, 768])
Parameter name: pre_train_model.encoder.layer.11.attention.self.key.bias 	Shape: torch.Size([768])
Parameter name: pre_train_model.encoder.layer.11.attention.self.value.weight 	Shape: torch.Size([768, 768])
Parameter name: pre_train_model.encoder.layer.11.attention.self.value.bias 	Shape: torch.Size([768])
Parameter name: pre_train_model.encoder.layer.11.attention.output.dense.weight 	Shape: torch.Size([768, 768])
Parameter name: pre_train_model.encoder.layer.11.attention.output.dense.bias 	Shape: torch.Size([768])
Parameter name: pre_train_model.encoder.layer.11.attention.output.LayerNorm.weight 	Shape: torch.Size([768])
Parameter name: pre_train_model.encoder.layer.11.attention.output.LayerNorm.bias 	Shape: torch.Size([768])
Parameter name: pre_train_model.encoder.layer.11.intermediate.dense.weight 	Shape: torch.Size([3072, 768])
Parameter name: pre_train_model.encoder.layer.11.intermediate.dense.bias 	Shape: torch.Size([3072])
Parameter name: pre_train_model.encoder.layer.11.output.dense.weight 	Shape: torch.Size([768, 3072])
Parameter name: pre_train_model.encoder.layer.11.output.dense.bias 	Shape: torch.Size([768])
Parameter name: pre_train_model.encoder.layer.11.output.LayerNorm.weight 	Shape: torch.Size([768])
Parameter name: pre_train_model.encoder.layer.11.output.LayerNorm.bias 	Shape: torch.Size([768])
Parameter name: pre_train_model.pooler.dense.weight 	Shape: torch.Size([768, 768])
Parameter name: pre_train_model.pooler.dense.bias 	Shape: torch.Size([768])
Parameter name: logits.fc1.weight 	Shape: torch.Size([64, 769])
Parameter name: logits.fc1.bias 	Shape: torch.Size([64])
Parameter name: logits.fc3.weight 	Shape: torch.Size([1, 64])
Parameter name: logits.fc3.bias 	Shape: torch.Size([1])
